Appu#i	Appui
Lu#i	Lui
appu#i	appui
bi#en	bien
bi#entôt	bientôt
emploi#e	emploie
derni#ère	dernière
galanteri#es	galanteries
puis
rédu#ire	réduire
tyranni#e	tyrannie
y#eux	yeux
détru#it	détruit
su#is	suis
puniti#on	punition

piti#é	pitié
amiti#é	amitié
rédu#ire	réduire
premi#er	premier

justifi#ée	justifiée
éblou#ie	éblouie

Éthi#opie	Éthiopie

que tu n'es

stances
Suivantes, PR en 12 (finales)
Rodo : Une main qui nous fut bien chères
Héra : Sers ton prince, et venge ton père.

